{
  "id": "SIMPLE_TEST",
  "width": 5,
  "height": 7,
  "centerOnZero": true,
  "cells": [
    { "x": 0, "y": 0, "t": "F0" },
    { "x": 1, "y": 0, "t": "F0" },
    { "x": 2, "y": 0, "t": "F0" },
    { "x": 3, "y": 0, "t": "F0" },
    { "x": 4, "y": 0, "t": "F0" },

    { "x": 0, "y": 1, "t": "F0" },
    { "x": 4, "y": 1, "t": "F0" },

    { "x": 0, "y": 2, "t": "F0" },
    { "x": 4, "y": 2, "t": "F0" },

    { "x": 0, "y": 3, "t": "F0" },
    { "x": 1, "y": 3, "t": "F0" },
    { "x": 2, "y": 3, "t": "F0" },
    { "x": 3, "y": 3, "t": "F0" },
    { "x": 4, "y": 3, "t": "F0" },

    { "x": 0, "y": 4, "t": "F0" },
    { "x": 1, "y": 4, "t": "F0" },
    { "x": 2, "y": 4, "t": "F0" },
    { "x": 3, "y": 4, "t": "F0" },
    { "x": 4, "y": 4, "t": "F0" },

    { "x": 0, "y": 5, "t": "F0" },
    { "x": 1, "y": 5, "t": "F0" },
    { "x": 2, "y": 5, "t": "F0" },
    { "x": 3, "y": 5, "t": "F0" },
    { "x": 4, "y": 5, "t": "F0" },

    { "x": 0, "y": 6, "t": "F0" },
    { "x": 1, "y": 6, "t": "F0" },
    { "x": 2, "y": 6, "t": "F0" },
    { "x": 3, "y": 6, "t": "F0" },
    { "x": 4, "y": 6, "t": "F0" }
  ]
}
